Rank,NOC,Gold,Silver,Bronze,Total,Year
1,0,11,7,2,20,0
2,1,10,18,19,47,0
3,2,6,5,2,13,0
4,3,5,4,2,11,0
5,4,2,3,2,7,0
6,5,2,1,3,6,0
7,6,2,1,2,5,0
8,7,2,0,0,2,0
9,8,1,2,3,6,0
10,9,1,2,0,3,0
11,10,1,0,1,2,0
1,3,27,39,37,103,1
2,0,19,14,15,48,1
3,4,15,7,9,31,1
4,10,8,5,6,19,1
5,11,6,7,4,17,1
6,9,6,2,1,9,1
7,2,4,3,2,9,1
8,12,3,2,0,5,1
9,7,2,0,3,5,1
10,8,1,3,2,6,1
11,5,1,2,2,5,1
12,13,1,1,0,2,1
13,14,1,0,1,2,1
14,15,1,0,0,1,1
14,16,1,0,0,1,1
16,6,0,3,3,6,1
17,17,0,2,3,5,1
17,18,0,2,3,5,1
19,19,0,2,0,2,1
20,20,0,1,1,2,1
21,21,0,0,1,1,1
1,0,76,78,77,231,2
2,2,4,5,6,15,2
3,14,4,1,1,6,2
4,13,3,0,0,3,2
5,5,2,1,1,4,2
5,10,2,1,1,4,2
7,17,2,0,0,2,2
8,6,1,1,1,3,2
9,4,1,1,0,2,2
10,9,1,0,2,3,2
11,1,1,0,1,2,2
12,7,0,3,1,4,2
13,3,0,1,0,1,2
1,4,56,51,39,146,3
2,0,23,12,12,47,3
3,21,8,6,11,25,3
4,3,5,5,9,19,3
5,2,3,5,5,13,3
6,5,3,4,2,9,3
7,14,3,3,10,16,3
8,17,2,3,3,8,3
9,12,2,2,0,4,3
10,11,1,5,2,8,3
11,22,1,2,2,5,3
12,23,1,2,0,3,3
13,24,1,1,3,5,3
14,25,1,1,0,2,3
15,1,0,3,1,4,3
16,8,0,2,3,5,3
17,20,0,0,2,2,3
17,18,0,0,2,2,3
19,6,0,0,1,1,3
1,0,26,19,19,64,4
2,21,23,25,17,65,4
3,4,10,15,16,41,4
4,24,9,8,9,26,4
5,3,7,4,3,14,4
6,2,5,13,7,25,4
7,25,4,2,0,6,4
8,17,3,2,5,10,4
9,14,3,2,3,8,4
9,5,3,2,3,8,4
11,12,3,1,2,6,4
12,22,2,2,3,7,4
13,11,2,1,3,6,4
14,8,1,6,5,12,4
15,1,1,0,1,2,4
16,23,0,2,3,5,4
17,6,0,2,2,4,4
18,18,0,0,3,3,4
1,0,41,27,27,95,5
2,21,19,20,25,64,5
3,24,15,10,9,34,5
4,4,14,15,13,42,5
5,11,14,11,11,36,5
6,17,13,9,9,31,5
7,12,13,5,5,23,5
8,3,9,19,13,41,5
9,18,4,2,5,11,5
10,8,3,9,1,13,5
11,25,3,4,3,10,5
12,14,3,3,3,9,5
13,9,2,2,7,11,5
14,26,1,2,0,3,5
15,27,1,1,1,3,5
16,7,0,2,1,3,5
17,28,0,2,0,2,5
17,15,0,2,0,2,5
19,1,0,1,0,1,5
19,16,0,1,0,1,5
21,29,0,0,2,2,5
22,30,0,0,1,1,5
1,0,45,27,27,99,6
2,24,14,13,10,37,6
3,3,13,15,10,38,6
4,4,9,13,12,34,6
5,12,8,3,5,16,6
6,9,7,8,10,25,6
7,17,5,2,3,10,6
8,21,4,13,12,29,6
9,18,4,1,5,10,6
10,11,3,7,3,13,6
11,7,3,1,2,6,6
12,8,2,5,2,9,6
13,5,2,3,4,9,6
14,31,2,0,0,2,6
15,29,1,4,5,10,6
16,32,1,3,2,6,6
17,26,1,1,4,6,6
18,25,1,1,1,3,6
19,33,1,0,0,1,6
20,6,0,3,1,4,6
20,14,0,3,1,4,6
22,34,0,1,1,2,6
23,35,0,0,1,1,6
23,28,0,0,1,1,6
23,30,0,0,1,1,6
23,36,0,0,1,1,6
23,37,0,0,1,1,6
1,0,22,18,16,56,7
2,2,10,7,14,31,7
3,24,8,8,9,25,7
4,21,7,6,12,25,7
5,12,7,5,7,19,7
6,9,7,4,4,15,7
7,3,6,10,5,21,7
8,18,6,9,4,19,7
9,5,4,5,0,9,7
10,14,4,4,7,15,7
11,4,3,10,7,20,7
12,32,3,3,1,7,7
13,8,3,1,2,6,7
14,29,2,5,2,9,7
15,28,2,2,1,5,7
16,26,2,1,2,5,7
17,38,2,1,1,4,7
18,6,2,0,1,3,7
19,7,1,2,1,4,7
19,17,1,2,1,4,7
21,34,1,1,3,5,7
21,31,1,1,3,5,7
23,25,1,0,2,3,7
24,19,1,0,0,1,7
24,39,1,0,0,1,7
24,30,1,0,0,1,7
24,15,1,0,0,1,7
24,33,1,0,0,1,7
29,11,0,1,2,3,7
30,40,0,1,0,1,7
30,35,0,1,0,1,7
32,41,0,0,1,1,7
32,36,0,0,1,1,7
1,42,44,36,30,110,8
2,43,12,12,12,36,8
3,44,11,5,4,20,8
4,45,10,5,9,24,8
5,46,7,7,4,18,8
6,47,6,5,5,16,8
7,48,5,12,7,24,8
8,49,5,8,12,25,8
9,50,5,7,5,17,8
10,51,3,2,4,9,8
11,52,3,1,1,5,8
12,53,3,1,0,4,8
13,54,2,5,9,16,8
14,55,2,5,1,8,8
15,56,2,0,3,5,8
16,57,2,0,0,2,8
17,58,1,3,2,6,8
18,59,1,1,3,5,8
19,60,1,0,0,1,8
20,61,0,5,3,8,8
21,62,0,2,0,2,8
22,63,0,1,0,1,8
22,64,0,1,0,1,8
22,65,0,1,0,1,8
25,66,0,0,3,3,8
26,67,0,0,1,1,8
26,68,0,0,1,1,8
26,69,0,0,1,1,8
1,2,38,31,32,101,9
2,0,24,21,12,57,9
3,5,10,1,5,16,9
4,12,9,13,5,27,9
5,24,8,6,6,20,9
6,3,7,6,6,19,9
7,21,6,5,10,21,9
8,28,6,4,10,20,9
9,18,6,4,7,17,9
10,6,5,7,5,17,9
11,9,4,9,5,18,9
12,4,4,7,3,14,9
13,29,3,5,1,9,9
14,32,2,2,3,7,9
14,26,2,2,3,7,9
16,38,2,1,2,5,9
17,14,1,3,5,9,9
18,17,1,3,2,6,9
19,70,1,0,1,2,9
20,19,1,0,0,1,9
20,30,1,0,0,1,9
22,34,0,4,5,9,9
23,8,0,2,3,5,9
24,71,0,1,1,2,9
25,37,0,1,0,1,9
25,25,0,1,0,1,9
25,31,0,1,0,1,9
28,11,0,0,3,3,9
28,72,0,0,3,3,9
30,7,0,0,1,1,9
30,41,0,0,1,1,9
30,36,0,0,1,1,9
1,0,38,27,19,84,10
2,21,16,11,17,44,10
3,3,10,6,13,29,10
4,5,10,5,12,27,10
5,12,8,11,8,27,10
6,24,8,7,5,20,10
7,70,6,4,2,12,10
8,29,6,2,3,11,10
9,9,5,10,5,20,10
10,8,5,7,8,20,10
11,18,5,2,9,16,10
12,4,3,14,6,23,10
13,32,3,3,1,7,10
14,7,2,6,5,13,10
15,11,2,2,3,7,10
16,38,2,2,1,5,10
17,72,2,1,2,5,10
18,25,2,1,1,4,10
19,17,1,3,3,7,10
20,73,1,2,0,3,10
21,6,1,0,3,4,10
22,19,1,0,0,1,10
22,74,1,0,0,1,10
24,31,0,2,0,2,10
25,14,0,1,2,3,10
26,36,0,1,1,2,10
26,33,0,1,1,2,10
28,75,0,1,0,1,10
28,13,0,1,0,1,10
28,15,0,1,0,1,10
28,76,0,1,0,1,10
32,77,0,0,2,2,10
32,78,0,0,2,2,10
34,27,0,0,1,1,10
34,79,0,0,1,1,10
34,34,0,0,1,1,10
34,80,0,0,1,1,10
1,0,40,19,17,76,11
2,81,22,30,19,71,11
3,5,16,10,16,42,11
4,21,12,13,10,35,11
5,12,8,9,4,21,11
6,29,7,3,3,13,11
7,3,6,6,6,18,11
8,24,6,3,13,22,11
9,7,6,2,3,11,11
10,17,3,2,0,5,11
11,9,2,6,6,14,11
12,25,2,4,4,10,11
13,73,2,3,0,5,11
14,11,2,2,0,4,11
15,8,2,1,3,6,11
16,70,2,0,1,3,11
17,28,1,6,2,9,11
18,4,1,2,8,11,11
19,32,1,2,2,5,11
20,34,1,2,1,4,11
21,14,1,2,0,3,11
21,31,1,2,0,3,11
23,37,1,1,2,4,11
24,27,1,0,2,3,11
24,30,1,0,2,3,11
26,19,1,0,1,2,11
27,16,1,0,0,1,11
28,2,0,7,17,24,11
29,18,0,5,0,5,11
30,79,0,3,4,7,11
31,40,0,2,0,2,11
32,6,0,1,1,2,11
32,82,0,1,1,2,11
34,39,0,1,0,1,11
34,72,0,1,0,1,11
34,15,0,1,0,1,11
37,78,0,0,2,2,11
37,76,0,0,2,2,11
37,33,0,0,2,2,11
40,83,0,0,1,1,11
40,38,0,0,1,1,11
40,36,0,0,1,1,11
40,84,0,0,1,1,11
1,81,37,29,32,98,12
2,0,32,25,17,74,12
3,7,13,8,14,35,12
4,5,9,10,7,26,12
5,12,8,8,9,25,12
6,21,8,5,6,19,12
7,85,6,13,7,26,12
8,4,6,7,11,24,12
9,37,5,3,5,13,12
10,28,4,10,5,19,12
11,3,4,4,6,14,12
12,70,3,2,2,7,12
13,24,3,1,11,15,12
14,79,2,2,1,5,12
15,14,2,1,3,6,12
16,30,2,0,0,2,12
17,34,1,4,4,9,12
18,29,1,4,1,6,12
19,83,1,3,1,5,12
20,8,1,2,1,4,12
21,39,1,1,3,5,12
22,17,1,0,2,3,12
23,72,1,0,1,2,12
24,27,1,0,0,1,12
24,19,1,0,0,1,12
26,31,0,3,0,3,12
27,40,0,2,2,4,12
28,11,0,2,0,2,12
29,32,0,1,1,2,12
29,78,0,1,1,2,12
31,86,0,1,0,1,12
31,87,0,1,0,1,12
33,25,0,0,4,4,12
34,6,0,0,2,2,12
35,88,0,0,1,1,12
35,1,0,0,1,1,12
35,9,0,0,1,1,12
35,33,0,0,1,1,12
1,89,43,29,31,103,13
2,42,34,21,16,71,13
3,43,13,10,13,36,13
4,90,12,19,11,42,13
5,52,8,8,6,22,13
6,91,7,2,0,9,13
7,47,6,8,7,21,13
8,46,4,7,7,18,13
9,51,4,6,11,21,13
10,58,3,2,3,8,13
11,92,3,1,6,10,13
12,50,2,6,12,20,13
13,61,2,3,1,6,13
14,64,2,0,1,3,13
15,93,1,3,3,7,13
16,45,1,2,3,6,13
17,49,1,1,3,5,13
18,59,1,1,0,2,13
18,94,1,1,0,2,13
20,95,1,0,1,2,13
21,96,1,0,0,1,13
21,97,1,0,0,1,13
21,98,1,0,0,1,13
24,65,0,3,3,6,13
25,44,0,2,3,5,13
26,67,0,2,2,4,13
27,99,0,1,3,4,13
28,55,0,1,2,3,13
28,56,0,1,2,3,13
30,53,0,1,1,2,13
30,100,0,1,1,2,13
32,54,0,1,0,1,13
32,101,0,1,0,1,13
32,102,0,1,0,1,13
32,60,0,1,0,1,13
32,103,0,1,0,1,13
32,104,0,1,0,1,13
32,105,0,1,0,1,13
39,106,0,0,2,2,13
39,107,0,0,2,2,13
41,108,0,0,1,1,13
41,62,0,0,1,1,13
41,68,0,0,1,1,13
41,109,0,0,1,1,13
1,0,36,26,28,90,14
2,81,30,31,35,96,14
3,28,16,5,8,29,14
4,85,10,22,18,50,14
5,12,10,10,7,27,14
6,5,10,7,5,22,14
7,34,7,6,10,23,14
8,7,6,2,10,18,14
9,29,5,6,3,14,14
10,4,4,12,2,18,14
11,83,3,5,2,10,14
12,24,3,0,2,5,14
12,30,3,0,2,5,14
14,37,2,4,6,12,14
15,18,2,4,4,10,14
16,70,2,3,1,6,14
17,21,2,2,4,8,14
18,8,2,1,3,6,14
19,31,2,1,2,5,14
20,11,2,0,1,3,14
21,3,1,8,6,15,14
22,14,1,2,1,4,14
22,9,1,2,1,4,14
24,88,1,0,0,1,14
24,110,1,0,0,1,14
24,19,1,0,0,1,14
27,78,0,2,1,3,14
28,76,0,1,2,3,14
29,111,0,1,1,2,14
30,32,0,1,0,1,14
30,13,0,1,0,1,14
30,87,0,1,0,1,14
30,41,0,1,0,1,14
34,79,0,0,2,2,14
35,27,0,0,1,1,14
35,112,0,0,1,1,14
35,39,0,0,1,1,14
35,113,0,0,1,1,14
35,72,0,0,1,1,14
35,114,0,0,1,1,14
35,33,0,0,1,1,14
1,0,45,28,34,107,15
2,81,29,32,30,91,15
3,28,11,7,7,25,15
4,5,10,10,12,32,15
5,115,9,9,7,25,15
6,3,7,3,5,15,15
7,29,7,2,4,13,15
8,116,5,11,10,26,15
9,7,5,7,5,17,15
10,4,5,5,3,13,15
11,34,5,2,11,18,15
12,37,4,6,5,15,15
13,12,3,4,9,16,15
14,113,3,4,2,9,15
15,72,3,3,3,9,15
16,31,3,3,2,8,15
17,18,3,3,1,7,15
18,83,2,4,3,9,15
19,79,2,1,2,5,15
20,21,2,1,1,4,15
21,70,2,0,0,2,15
22,8,1,4,3,8,15
23,14,1,3,1,5,15
24,24,1,2,1,4,15
25,110,1,1,0,2,15
25,17,1,1,0,2,15
27,30,1,0,2,3,15
28,111,1,0,1,2,15
29,87,1,0,0,1,15
29,84,1,0,0,1,15
31,13,0,4,0,4,15
32,6,0,2,2,4,15
33,9,0,1,4,5,15
34,117,0,1,3,4,15
35,27,0,1,2,3,15
36,11,0,1,1,2,15
36,78,0,1,1,2,15
36,118,0,1,1,2,15
39,119,0,1,0,1,15
39,73,0,1,0,1,15
41,32,0,0,2,2,15
42,1,0,0,1,1,15
42,19,0,0,1,1,15
42,120,0,0,1,1,15
1,81,50,27,22,99,16
2,0,33,31,30,94,16
3,115,20,23,23,66,16
4,116,13,11,16,40,16
5,28,13,8,8,29,16
6,7,8,7,2,17,16
7,34,7,5,9,21,16
8,5,6,13,16,35,16
9,83,6,10,5,21,16
10,12,5,3,10,18,16
11,21,4,6,6,16,16
12,4,4,5,9,18,16
13,37,3,6,7,16,16
14,13,3,1,4,8,16
14,24,3,1,4,8,16
16,18,3,1,1,5,16
17,3,2,4,7,13,16
18,29,2,4,2,8,16
19,113,2,3,4,9,16
20,31,2,1,2,5,16
21,17,2,1,1,4,16
22,121,1,1,3,5,16
23,30,1,1,1,3,16
24,118,1,1,0,2,16
25,8,1,0,0,1,16
26,9,0,3,0,3,16
27,14,0,2,3,5,16
28,79,0,2,1,3,16
29,11,0,2,0,2,16
29,1,0,2,0,2,16
31,6,0,1,2,3,16
31,122,0,1,2,3,16
33,32,0,1,0,1,16
33,82,0,1,0,1,16
33,72,0,1,0,1,16
33,117,0,1,0,1,16
33,87,0,1,0,1,16
33,78,0,1,0,1,16
33,111,0,1,0,1,16
33,70,0,1,0,1,16
41,27,0,0,2,2,16
41,110,0,0,2,2,16
43,112,0,0,1,1,16
43,19,0,0,1,1,16
43,73,0,0,1,1,16
43,123,0,0,1,1,16
43,114,0,0,1,1,16
43,15,0,0,1,1,16
1,81,49,41,35,125,17
2,115,40,25,25,90,17
3,0,34,35,25,94,17
4,116,10,12,17,39,17
5,28,9,6,10,25,17
6,34,7,6,13,26,17
7,83,6,9,7,22,17
8,13,6,4,3,13,17
9,37,4,9,14,27,17
10,5,4,5,13,22,17
11,24,4,2,0,6,17
12,21,4,1,0,5,17
13,4,3,5,5,13,17
14,12,2,7,4,13,17
15,3,2,3,4,9,17
16,31,2,3,3,8,17
17,29,2,2,4,8,17
18,30,2,1,1,4,17
19,78,1,1,4,6,17
20,9,1,1,2,4,17
21,73,1,1,0,2,17
21,121,1,1,0,2,17
21,17,1,1,0,2,17
24,8,1,0,2,3,17
25,72,1,0,1,2,17
26,76,1,0,0,1,17
27,14,0,5,6,11,17
28,11,0,3,3,6,17
29,18,0,2,3,5,17
30,36,0,2,0,2,17
30,15,0,2,0,2,17
32,7,0,1,4,5,17
33,79,0,1,1,2,17
34,117,0,1,0,1,17
34,84,0,1,0,1,17
36,27,0,0,2,2,17
37,6,0,0,1,1,17
37,124,0,0,1,1,17
37,87,0,0,1,1,17
37,80,0,0,1,1,17
37,125,0,0,1,1,17
1,81,80,69,46,195,18
2,115,47,37,42,126,18
3,83,8,16,17,41,18
4,13,8,7,5,20,18
5,12,8,3,4,15,18
6,5,7,10,15,32,18
7,37,6,6,13,25,18
8,3,6,5,3,14,18
9,4,5,7,9,21,18
10,34,3,14,15,32,18
11,21,3,3,6,12,18
12,24,3,1,4,8,18
13,29,2,3,9,14,18
14,31,2,3,4,9,18
15,7,2,2,5,9,18
16,8,2,1,2,5,18
17,27,2,0,2,4,18
17,110,2,0,2,4,18
19,9,2,0,0,2,18
20,15,1,3,2,6,18
21,6,1,2,1,4,18
22,1,1,0,2,3,18
23,11,1,0,0,1,18
23,19,1,0,0,1,18
23,126,1,0,0,1,18
26,121,0,3,2,5,18
27,117,0,2,2,4,18
28,127,0,2,0,2,18
29,72,0,1,3,4,18
30,18,0,1,2,3,18
31,39,0,1,1,2,18
32,118,0,1,0,1,18
32,84,0,1,0,1,18
34,73,0,0,3,3,18
35,128,0,0,1,1,18
35,82,0,0,1,1,18
1,0,83,61,30,174,19
2,37,20,16,17,53,19
3,116,17,19,23,59,19
4,129,15,8,9,32,19
5,12,14,6,12,32,19
6,14,10,18,16,44,19
7,28,10,8,14,32,19
8,30,8,1,2,11,19
9,31,7,4,7,18,19
10,78,6,6,7,19,19
11,4,5,11,21,37,19
12,3,5,7,16,28,19
13,18,5,2,6,13,19
14,7,4,8,12,24,19
15,24,4,2,6,12,19
16,21,2,11,6,19,19
17,72,2,3,1,6,19
18,130,2,0,0,2,19
19,27,1,5,2,8,19
20,15,1,2,2,5,19
21,11,1,1,2,4,19
22,6,1,1,1,3,19
23,113,1,0,2,3,19
23,36,1,0,2,3,19
25,87,1,0,0,1,19
26,9,0,4,4,8,19
27,8,0,3,3,6,19
28,73,0,1,2,3,19
28,17,0,1,2,3,19
30,1,0,1,1,2,19
30,114,0,1,1,2,19
30,80,0,1,1,2,19
33,122,0,1,0,1,19
33,38,0,1,0,1,19
33,39,0,1,0,1,19
33,131,0,1,0,1,19
33,74,0,1,0,1,19
33,132,0,1,0,1,19
33,125,0,1,0,1,19
40,70,0,0,3,3,19
40,84,0,0,3,3,19
42,133,0,0,2,2,19
43,119,0,0,1,1,19
43,134,0,0,1,1,19
43,135,0,0,1,1,19
43,86,0,0,1,1,19
43,136,0,0,1,1,19
1,81,55,31,46,132,20
2,115,37,35,30,102,20
3,0,36,31,27,94,20
4,78,12,10,11,33,20
5,116,11,14,15,40,20
6,5,11,6,6,23,20
7,83,10,12,13,35,20
8,37,7,11,6,24,20
9,3,6,4,6,16,20
10,12,6,4,4,14,20
11,129,5,11,12,28,20
12,4,5,10,9,24,20
13,113,5,2,2,9,20
14,28,4,3,7,14,20
15,7,3,6,5,14,20
16,31,3,4,5,12,20
17,29,3,3,2,8,20
18,30,3,2,8,13,20
19,14,3,2,5,10,20
20,34,2,5,9,16,20
21,17,2,3,0,5,20
22,18,2,2,5,9,20
23,8,2,1,1,4,20
24,27,1,2,3,6,20
25,24,1,1,2,4,20
25,15,1,1,2,4,20
27,70,1,1,0,2,20
28,130,1,0,2,3,20
29,6,1,0,0,1,20
29,36,1,0,0,1,20
29,137,1,0,0,1,20
32,21,0,4,7,11,20
33,9,0,2,2,4,20
34,73,0,2,0,2,20
35,32,0,1,1,2,20
36,40,0,1,0,1,20
36,138,0,1,0,1,20
36,139,0,1,0,1,20
36,79,0,1,0,1,20
36,140,0,1,0,1,20
36,74,0,1,0,1,20
36,141,0,1,0,1,20
36,142,0,1,0,1,20
44,11,0,0,2,2,20
44,72,0,0,2,2,20
46,122,0,0,1,1,20
46,143,0,0,1,1,20
46,1,0,0,1,1,20
46,117,0,0,1,1,20
46,87,0,0,1,1,20
46,41,0,0,1,1,20
46,125,0,0,1,1,20
1,144,45,38,29,112,21
2,0,37,34,37,108,21
3,2,33,21,28,82,21
4,129,16,22,16,54,21
5,13,14,6,11,31,21
6,15,13,7,2,22,21
7,78,12,5,12,29,21
8,5,11,12,7,30,21
9,3,8,5,16,29,21
10,7,7,9,11,27,21
11,14,7,4,7,18,21
12,12,6,5,8,19,21
13,4,5,3,12,20,21
14,37,4,6,8,18,21
15,29,4,2,1,7,21
16,121,4,0,5,9,21
17,28,3,8,11,22,21
18,83,3,7,6,16,21
19,34,3,6,10,19,21
20,18,2,6,7,15,21
21,113,2,4,2,8,21
22,17,2,4,1,7,21
23,70,2,2,2,6,21
24,139,2,2,1,5,21
25,27,2,1,0,3,21
26,1,2,0,0,2,21
27,21,1,7,4,12,21
28,30,1,4,5,10,21
29,24,1,2,2,5,21
30,8,1,1,4,6,21
31,130,1,1,1,3,21
32,39,1,1,0,2,21
33,110,1,0,2,3,21
34,133,1,0,1,2,21
34,26,1,0,1,2,21
34,145,1,0,1,2,21
37,9,1,0,0,1,21
38,73,0,3,1,4,21
38,114,0,3,1,4,21
40,71,0,2,1,3,21
41,6,0,2,0,2,21
41,146,0,2,0,2,21
41,25,0,2,0,2,21
44,11,0,1,2,3,21
44,147,0,1,2,3,21
44,148,0,1,2,3,21
44,79,0,1,2,3,21
48,149,0,1,1,2,21
49,134,0,1,0,1,21
49,72,0,1,0,1,21
49,74,0,1,0,1,21
52,117,0,0,2,2,21
52,150,0,0,2,2,21
54,32,0,0,1,1,21
54,88,0,0,1,1,21
54,122,0,0,1,1,21
54,112,0,0,1,1,21
54,151,0,0,1,1,21
54,87,0,0,1,1,21
54,41,0,0,1,1,21
54,80,0,0,1,1,21
54,152,0,0,1,1,21
54,137,0,0,1,1,21
54,125,0,0,1,1,21
1,0,44,32,25,101,22
2,153,26,21,16,63,22
3,2,20,18,27,65,22
4,129,16,22,12,50,22
5,3,15,7,15,37,22
6,12,13,10,12,35,22
7,7,9,9,23,41,22
8,13,9,8,8,25,22
9,154,9,2,12,23,22
10,78,7,15,5,27,22
11,34,7,5,5,17,22
12,5,7,4,10,21,22
13,15,5,6,6,17,22
14,37,4,7,9,20,22
15,18,4,5,10,19,22
16,1,4,4,0,8,22
17,155,4,3,4,11,22
18,9,4,3,0,7,22
19,8,4,1,1,6,22
19,70,4,1,1,6,22
21,14,3,11,8,22,22
22,83,3,7,5,15,22
23,28,3,6,5,14,22
24,156,3,4,4,11,22
25,27,3,3,9,15,22
26,30,3,2,1,6,22
27,25,3,1,1,5,22
28,39,3,0,1,4,22
29,21,2,4,2,8,22
30,17,2,2,3,7,22
31,11,2,2,2,6,22
32,114,2,1,3,6,22
33,121,2,1,2,5,22
34,133,2,0,1,3,22
34,110,2,0,1,3,22
36,4,1,8,6,15,22
37,157,1,6,8,15,22
38,113,1,4,3,8,22
39,73,1,3,2,6,22
40,24,1,2,1,4,22
41,158,1,1,2,4,22
41,139,1,1,2,4,22
43,79,1,1,1,3,22
43,159,1,1,1,3,22
45,160,1,1,0,2,22
45,147,1,1,0,2,22
47,36,1,0,1,2,22
47,125,1,0,1,2,22
49,161,1,0,0,1,22
49,138,1,0,0,1,22
49,162,1,0,0,1,22
49,163,1,0,0,1,22
49,132,1,0,0,1,22
54,32,0,2,1,3,22
55,146,0,2,0,2,22
55,150,0,2,0,2,22
57,6,0,1,2,3,22
58,151,0,1,1,2,22
58,164,0,1,1,2,22
58,165,0,1,1,2,22
61,166,0,1,0,1,22
61,88,0,1,0,1,22
61,134,0,1,0,1,22
61,71,0,1,0,1,22
61,41,0,1,0,1,22
61,167,0,1,0,1,22
61,136,0,1,0,1,22
68,168,0,0,2,2,22
68,130,0,0,2,2,22
68,76,0,0,2,2,22
71,19,0,0,1,1,22
71,149,0,0,1,1,22
71,145,0,0,1,1,22
71,72,0,0,1,1,22
71,117,0,0,1,1,22
71,169,0,0,1,1,22
71,80,0,0,1,1,22
71,111,0,0,1,1,22
71,118,0,0,1,1,22
1,0,37,24,32,93,23
2,153,32,28,29,89,23
3,129,28,16,14,58,23
4,7,16,25,17,58,23
5,2,13,17,26,56,23
6,3,13,14,11,38,23
7,12,13,8,13,34,23
8,18,12,9,4,25,23
9,13,11,11,7,29,23
10,4,11,10,7,28,23
11,37,11,6,9,26,23
12,78,8,10,10,28,23
13,5,8,6,3,17,23
14,34,6,5,3,14,23
15,28,5,8,5,18,23
16,83,5,6,2,13,23
17,1,4,6,3,13,23
18,21,4,5,3,12,23
19,17,4,3,3,10,23
20,110,4,1,3,8,23
21,154,3,10,10,23,23
22,156,3,4,0,7,23
23,157,3,3,11,17,23
24,14,3,3,8,14,23
25,15,3,3,5,11,23
26,70,3,0,2,5,23
27,79,3,0,1,4,23
28,155,2,3,3,8,23
29,113,2,3,2,7,23
30,8,2,3,1,6,23
31,24,2,1,1,4,23
32,6,2,1,0,3,23
33,145,2,0,3,5,23
34,166,2,0,1,3,23
34,88,2,0,1,3,23
36,150,2,0,0,2,23
37,9,1,6,2,9,23
38,139,1,3,2,6,23
39,159,1,3,1,5,23
40,72,1,2,3,6,23
41,114,1,2,0,3,23
42,133,1,1,3,5,23
43,165,1,1,2,4,23
44,158,1,1,1,3,23
44,71,1,1,1,3,23
46,30,1,0,3,4,23
47,26,1,0,2,3,23
47,125,1,0,2,3,23
49,147,1,0,1,2,23
50,119,1,0,0,1,23
50,122,1,0,0,1,23
50,169,1,0,0,1,23
53,27,0,6,6,12,23
54,73,0,6,3,9,23
55,11,0,2,3,5,23
55,25,0,2,3,5,23
57,32,0,2,2,4,23
58,134,0,1,4,5,23
58,130,0,1,4,5,23
60,121,0,1,3,4,23
61,164,0,1,1,2,23
61,170,0,1,1,2,23
61,76,0,1,1,2,23
64,39,0,1,0,1,23
64,171,0,1,0,1,23
64,33,0,1,0,1,23
64,172,0,1,0,1,23
68,168,0,0,6,6,23
69,138,0,0,2,2,23
69,36,0,0,2,2,23
71,160,0,0,1,1,23
71,173,0,0,1,1,23
71,40,0,0,1,1,23
71,86,0,0,1,1,23
71,19,0,0,1,1,23
71,149,0,0,1,1,23
71,174,0,0,1,1,23
71,175,0,0,1,1,23
71,176,0,0,1,1,23
71,152,0,0,1,1,23
1,0,36,39,26,101,24
2,129,32,17,14,63,24
3,153,28,26,36,90,24
4,7,17,16,17,50,24
5,28,16,9,12,37,24
6,2,13,16,20,49,24
7,3,11,9,13,33,24
8,12,10,11,11,32,24
9,78,9,12,9,30,24
10,4,9,9,12,30,24
11,13,9,7,11,27,24
12,5,8,6,3,17,24
13,154,8,5,9,22,24
14,37,8,5,6,19,24
15,1,6,6,4,16,24
16,27,5,2,3,10,24
17,17,5,0,1,6,24
18,18,4,9,9,22,24
19,21,4,2,1,7,24
20,15,3,11,6,20,24
21,14,3,6,3,12,24
22,70,3,3,4,10,24
23,34,3,2,5,10,24
24,30,3,2,0,5,24
25,125,3,1,4,8,24
26,157,2,5,6,13,24
27,6,2,4,1,7,24
28,110,2,3,2,7,24
29,79,2,2,2,6,24
29,159,2,2,2,6,24
31,134,2,2,1,5,24
32,168,2,2,0,4,24
33,83,2,1,9,12,24
34,8,2,1,5,8,24
35,73,2,1,2,5,24
35,165,2,1,2,5,24
37,130,2,1,0,3,24
38,32,2,0,4,6,24
39,40,2,0,1,3,24
40,156,1,4,3,8,24
41,113,1,4,2,7,24
42,155,1,3,5,9,24
43,25,1,3,2,6,24
44,147,1,2,2,5,24
45,145,1,2,0,3,24
46,38,1,1,3,5,24
46,9,1,1,3,5,24
48,139,1,1,2,4,24
49,126,1,1,1,3,24
50,166,1,0,4,5,24
51,11,1,0,2,3,24
52,88,1,0,1,2,24
52,149,1,0,1,2,24
54,119,1,0,0,1,24
54,135,1,0,0,1,24
54,177,1,0,0,1,24
57,121,0,4,1,5,24
58,71,0,4,0,4,24
59,72,0,3,1,4,24
60,36,0,2,1,3,24
61,24,0,2,0,2,24
61,178,0,2,0,2,24
63,150,0,1,3,4,24
64,26,0,1,2,3,24
65,163,0,1,0,1,24
65,19,0,1,0,1,24
65,179,0,1,0,1,24
68,122,0,0,2,2,24
68,114,0,0,2,2,24
68,84,0,0,2,2,24
71,180,0,0,1,1,24
71,117,0,0,1,1,24
71,132,0,0,1,1,24
71,76,0,0,1,1,24
1,129,48,22,30,100,25
2,0,36,39,37,112,25
3,153,24,13,23,60,25
4,4,19,13,19,51,25
5,2,16,11,14,41,25
6,7,14,15,17,46,25
7,78,13,11,8,32,25
8,28,9,8,8,25,25
9,12,8,9,10,27,25
10,3,7,16,20,43,25
11,18,7,5,4,16,25
12,154,7,4,11,22,25
13,113,6,4,6,16,25
14,15,5,11,3,19,25
15,73,5,4,2,11,25
16,34,4,5,2,11,25
17,110,4,2,1,7,25
18,37,4,1,4,9,25
19,13,3,10,17,30,25
20,14,3,9,8,20,25
21,5,3,5,2,10,25
22,17,3,5,1,9,25
23,27,3,4,10,17,25
24,157,3,4,7,14,25
25,155,3,3,1,7,25
26,159,3,3,0,6,25
27,30,3,2,4,9,25
28,168,3,2,2,7,25
29,156,2,3,4,9,25
30,8,2,2,3,7,25
31,121,2,2,2,6,25
31,125,2,2,2,6,25
33,117,2,2,0,4,25
34,9,2,1,4,7,25
35,32,2,0,4,6,25
36,72,2,0,2,4,25
37,11,2,0,0,2,25
38,126,1,3,0,4,25
39,150,1,2,2,5,25
40,166,1,1,4,6,25
40,139,1,1,4,6,25
42,83,1,1,3,5,25
42,70,1,1,3,5,25
44,134,1,1,2,4,25
44,24,1,1,2,4,25
46,71,1,1,1,3,25
47,135,1,1,0,2,25
47,26,1,1,0,2,25
47,36,1,1,0,2,25
47,76,1,1,0,2,25
51,19,1,0,2,3,25
52,79,1,0,1,2,25
53,119,1,0,0,1,25
53,77,1,0,0,1,25
53,111,1,0,0,1,25
56,21,0,4,1,5,25
57,145,0,3,2,5,25
57,114,0,3,2,5,25
59,147,0,2,3,5,25
60,122,0,2,1,3,25
60,1,0,2,1,3,25
62,160,0,1,4,5,25
63,165,0,1,3,4,25
64,6,0,1,2,3,25
64,39,0,1,2,3,25
64,175,0,1,2,3,25
64,181,0,1,2,3,25
68,133,0,1,1,2,25
68,88,0,1,1,2,25
68,130,0,1,1,2,25
68,182,0,1,1,2,25
72,40,0,1,0,1,25
72,162,0,1,0,1,25
72,86,0,1,0,1,25
72,151,0,1,0,1,25
72,183,0,1,0,1,25
72,184,0,1,0,1,25
72,25,0,1,0,1,25
72,185,0,1,0,1,25
72,172,0,1,0,1,25
81,38,0,0,2,2,25
82,186,0,0,1,1,25
82,149,0,0,1,1,25
82,187,0,0,1,1,25
82,164,0,0,1,1,25
82,188,0,0,1,1,25
82,84,0,0,1,1,25
1,0,48,26,30,104,26
2,129,39,31,22,92,26
3,4,29,18,18,65,26
4,153,18,21,26,65,26
5,78,13,9,9,31,26
6,2,11,20,13,44,26
7,3,11,11,13,35,26
8,7,8,15,12,35,26
9,12,8,9,11,28,26
10,5,8,4,6,18,26
11,28,7,14,17,38,26
12,79,7,5,1,13,26
13,18,6,6,8,20,26
14,30,6,2,5,13,26
15,154,5,4,10,19,26
16,13,5,3,7,15,26
17,15,4,10,6,20,26
18,73,4,5,4,13,26
19,155,4,4,3,11,26
20,25,4,1,1,6,26
21,121,4,0,2,6,26
22,27,3,5,9,17,26
23,156,3,2,6,11,26
23,34,3,2,6,11,26
25,110,3,2,3,8,26
26,147,3,1,2,6,26
27,14,2,6,10,18,26
28,157,2,5,3,10,26
29,113,2,4,7,13,26
30,8,2,4,3,9,26
31,37,2,4,1,7,26
32,166,2,2,5,9,26
33,9,2,2,0,4,26
34,17,2,1,1,4,26
35,145,2,0,3,5,26
36,111,2,0,1,3,26
37,21,1,4,3,8,26
38,122,1,3,5,9,26
39,72,1,3,4,8,26
40,168,1,2,3,6,26
41,39,1,1,4,6,26
42,32,1,1,2,4,26
42,181,1,1,2,4,26
42,150,1,1,2,4,26
42,76,1,1,2,4,26
46,70,1,1,1,3,26
47,135,1,1,0,2,26
48,134,1,0,1,2,26
48,71,1,0,1,2,26
50,133,1,0,0,1,26
50,88,1,0,0,1,26
50,189,1,0,0,1,26
50,190,1,0,0,1,26
50,118,1,0,0,1,26
50,84,1,0,0,1,26
56,38,0,3,1,4,26
57,19,0,2,4,6,26
58,117,0,2,3,5,26
59,125,0,2,2,4,26
60,83,0,2,1,3,26
60,24,0,2,1,3,26
60,139,0,2,1,3,26
63,159,0,1,3,4,26
64,11,0,1,2,3,26
65,160,0,1,1,2,26
65,26,0,1,1,2,26
65,151,0,1,1,2,26
65,80,0,1,1,2,26
65,152,0,1,1,2,26
70,191,0,1,0,1,26
70,192,0,1,0,1,26
70,193,0,1,0,1,26
70,194,0,1,0,1,26
70,195,0,1,0,1,26
70,36,0,1,0,1,26
76,165,0,0,3,3,26
77,1,0,0,2,2,26
77,184,0,0,2,2,26
79,186,0,0,1,1,26
79,119,0,0,1,1,26
79,163,0,0,1,1,26
79,174,0,0,1,1,26
79,130,0,0,1,1,26
79,170,0,0,1,1,26
79,182,0,0,1,1,26
79,172,0,0,1,1,26
1,0,46,37,38,121,27
2,4,27,23,17,67,27
3,129,26,18,26,70,27
4,153,19,17,20,56,27
5,2,17,10,15,42,27
6,28,12,8,21,41,27
7,3,10,18,14,42,27
8,78,9,3,9,21,27
9,12,8,12,8,28,27
10,7,8,11,10,29,27
11,18,8,7,4,19,27
12,5,8,3,4,15,27
13,27,7,6,6,19,27
14,15,7,4,6,17,27
15,113,6,6,1,13,27
16,73,6,3,2,11,27
17,147,5,3,2,10,27
18,13,5,2,4,11,27
19,30,4,9,5,18,27
20,14,4,3,15,22,27
21,165,4,2,7,13,27
22,122,3,2,3,8,27
23,9,3,2,2,7,27
24,79,3,1,4,8,27
25,1,3,1,2,6,27
26,32,3,1,0,4,27
27,8,2,6,7,15,27
28,21,2,6,3,11,27
29,25,2,6,2,10,27
30,156,2,5,10,17,27
31,154,2,5,4,11,27
32,181,2,4,2,8,27
33,34,2,3,6,11,27
34,121,2,3,2,7,27
35,11,2,2,2,6,27
35,125,2,2,2,6,27
37,159,2,2,0,4,27
38,168,2,1,4,7,27
39,166,1,7,10,18,27
40,157,1,4,4,9,27
41,70,1,3,4,8,27
42,160,1,3,0,4,27
43,155,1,2,7,10,27
44,110,1,2,5,8,27
45,150,1,2,1,4,27
46,139,1,2,0,3,27
47,37,1,1,2,4,27
48,189,1,1,0,2,27
48,172,1,1,0,2,27
50,134,1,0,2,3,27
51,88,1,0,1,2,27
51,196,1,0,1,2,27
51,131,1,0,1,2,27
54,197,1,0,0,1,27
54,198,1,0,0,1,27
54,199,1,0,0,1,27
54,80,1,0,0,1,27
54,184,1,0,0,1,27
54,182,1,0,0,1,27
60,151,0,4,1,5,27
61,72,0,3,2,5,27
62,84,0,2,1,3,27
63,133,0,2,0,2,27
63,39,0,2,0,2,27
65,145,0,1,3,4,27
66,83,0,1,2,3,27
67,19,0,1,1,2,27
67,117,0,1,1,2,27
69,161,0,1,0,1,27
69,190,0,1,0,1,27
69,123,0,1,0,1,27
69,41,0,1,0,1,27
69,152,0,1,0,1,27
74,17,0,0,4,4,27
75,38,0,0,3,3,27
75,111,0,0,3,3,27
77,149,0,0,2,2,27
78,6,0,0,1,1,27
78,135,0,0,1,1,27
78,26,0,0,1,1,27
78,24,0,0,1,1,27
78,130,0,0,1,1,27
78,114,0,0,1,1,27
78,36,0,0,1,1,27
78,76,0,0,1,1,27
78,177,0,0,1,1,27
1,0,39,41,33,113,28
2,129,38,32,19,89,28
3,28,27,14,17,58,28
4,4,22,20,22,64,28
5,200,20,28,23,71,28
6,7,17,7,22,46,28
7,18,10,12,14,36,28
8,3,10,12,11,33,28
9,2,10,11,16,37,28
10,12,10,10,20,40,28
11,14,7,7,10,24,28
12,27,7,6,8,21,28
13,30,7,6,7,20,28
14,13,7,3,5,15,28
15,5,6,7,7,20,28
16,78,6,4,10,20,28
17,34,4,5,5,14,28
18,155,4,4,3,11,28
19,113,4,4,2,10,28
20,17,4,2,2,8,28
21,73,4,1,4,9,28
22,15,3,8,6,17,28
23,21,3,6,0,9,28
24,9,3,4,6,13,28
25,8,3,4,4,11,28
26,147,3,3,2,8,28
27,79,3,2,2,7,28
28,181,3,1,5,9,28
29,11,3,1,3,7,28
30,83,3,1,2,6,28
31,150,3,1,1,5,28
32,165,3,0,2,5,28
33,168,2,5,1,8,28
34,134,2,4,6,12,28
35,70,2,2,9,13,28
36,1,2,1,1,4,28
36,118,2,1,1,4,28
38,162,2,1,0,3,28
39,39,2,0,2,4,28
39,149,2,0,2,4,28
41,152,2,0,1,3,28
42,88,2,0,0,2,28
42,199,2,0,0,2,28
44,154,1,6,12,19,28
45,157,1,3,3,7,28
46,37,1,3,0,4,28
46,84,1,3,0,4,28
48,19,1,2,4,7,28
49,163,1,2,3,6,28
50,41,1,2,1,4,28
50,159,1,2,1,4,28
52,25,1,2,0,3,28
53,6,1,1,5,7,28
54,38,1,1,4,6,28
55,139,1,1,3,5,28
56,110,1,1,2,4,28
56,36,1,1,2,4,28
58,111,1,1,0,2,28
59,26,1,0,1,2,28
59,197,1,0,1,2,28
59,71,1,0,1,2,28
59,125,1,0,1,2,28
63,124,1,0,0,1,28
63,130,1,0,0,1,28
63,80,1,0,0,1,28
66,122,0,4,1,5,28
67,166,0,3,4,7,28
68,135,0,3,2,5,28
69,160,0,2,2,4,28
70,175,0,2,1,3,28
71,117,0,1,3,4,28
72,32,0,1,2,3,28
72,201,0,1,2,3,28
74,198,0,1,1,2,28
74,151,0,1,1,2,28
74,114,0,1,1,2,28
77,189,0,1,0,1,28
77,145,0,1,0,1,28
77,146,0,1,0,1,28
77,202,0,1,0,1,28
77,170,0,1,0,1,28
77,203,0,1,0,1,28
83,156,0,0,8,8,28
84,72,0,0,4,4,28
85,24,0,0,2,2,28
86,191,0,0,1,1,28
86,204,0,0,1,1,28
86,112,0,0,1,1,28
86,190,0,0,1,1,28
86,131,0,0,1,1,28
86,174,0,0,1,1,28
86,164,0,0,1,1,28
86,132,0,0,1,1,28
1,0,40,44,42,126,29
2,129,40,27,24,91,29
3,28,20,12,13,45,29
4,7,18,19,16,53,29
5,3,16,26,22,64,29
6,18,15,7,12,34,29
7,4,14,22,29,65,29
8,78,13,9,10,32,29
9,12,12,13,15,40,29
10,2,12,13,8,33,29
11,30,10,7,3,20,29
12,14,9,7,11,27,29
13,165,8,2,3,13,29
14,5,6,7,6,19,29
15,15,5,4,9,18,29
16,21,4,4,3,11,29
17,113,4,2,5,11,29
18,17,4,1,3,8,29
19,39,4,0,3,7,29
20,27,3,7,10,20,29
21,79,3,6,3,12,29
22,154,3,5,4,12,29
23,37,3,4,2,9,29
24,168,3,3,1,7,29
25,11,3,1,6,10,29
26,83,3,1,3,7,29
27,181,3,1,1,5,29
28,155,3,0,2,5,29
29,8,2,2,5,9,29
30,166,2,2,3,7,29
30,147,2,2,3,7,29
32,13,2,1,6,9,29
33,189,2,1,1,4,29
34,150,2,1,0,3,29
35,134,2,0,5,7,29
36,6,2,0,3,5,29
37,163,2,0,2,4,29
37,41,2,0,2,4,29
39,133,2,0,1,3,29
39,139,2,0,1,3,29
41,149,1,5,1,7,29
42,34,1,4,5,10,29
43,156,1,3,3,7,29
44,73,1,3,2,6,29
44,25,1,3,2,6,29
44,125,1,3,2,6,29
47,110,1,3,0,4,29
48,9,1,2,5,8,29
49,162,1,2,2,5,29
50,36,1,2,1,4,29
51,1,1,1,6,8,29
52,32,1,1,1,3,29
52,38,1,1,1,3,29
52,111,1,1,1,3,29
55,191,1,1,0,2,29
55,40,1,1,0,2,29
55,205,1,1,0,2,29
55,118,1,1,0,2,29
59,135,1,0,2,3,29
60,194,1,0,1,2,29
60,130,1,0,1,2,29
62,206,1,0,0,1,29
62,87,1,0,0,1,29
64,70,0,3,5,8,29
65,72,0,3,2,5,29
66,160,0,3,1,4,29
66,122,0,3,1,4,29
68,175,0,2,4,6,29
68,121,0,2,4,6,29
70,145,0,2,2,4,29
71,19,0,1,5,6,29
72,164,0,1,3,4,29
73,199,0,1,1,2,29
74,192,0,1,0,1,29
74,197,0,1,0,1,29
74,198,0,1,0,1,29
74,117,0,1,0,1,29
74,77,0,1,0,1,29
79,182,0,0,3,3,29
80,207,0,0,2,2,29
80,190,0,0,2,2,29
80,151,0,0,2,2,29
80,80,0,0,2,2,29
84,208,0,0,1,1,29
84,131,0,0,1,1,29
84,74,0,0,1,1,29
84,152,0,0,1,1,29
84,209,0,0,1,1,29
84,184,0,0,1,1,29
84,159,0,0,1,1,29
84,136,0,0,1,1,29
